010101010100043400000000000
111111111100043400000000000
111111111100555550000000000
222111111160043404444400000
222111110666043333333400000
222111100000034340444444444
211100000000004000004333333
111100000000000000003333333
222100777700000005443444443
221000777700000445434000044
121000777700004335400000000
211000777700003345000000000
221000000000043400000000000
111000000044433400006600000
220600004433333044406111100
116660043333333333401111100
000000433333333333001111100
000000433333333333011111110